AAA - om du har slutat kröka
SAS - där får man inte röka
ABF - det är sossarnas bildningsförbund

HSB - av dom kan man hyra
JAS - dom är svåra att styra
REM - det är när ögonen rör sig en stund

NJA - ett järnverk i Norrland
WHO - det är hon Gro Harlem Bruntland
SVT - dom har både Aktuellt och Rapport

LSD - det är farligt att svälja
CUF - det kan bondungar välja
IOK - Östersund röstas bort

STS - utomlands och pluggar
KGB - det är ryssar som buggar
PKK - turkar ifrån Kurdistan

OSA - om du råkar bli bjuden
PLO - dom som bråkar med juden
LRF - dom bor sällan inne i stan

SKF - det är kullagerfabriken
AIK - har värsta publiken
VDN - det är jättebra om du är kund

0LW - tillverkar chipsen
ATG - tar emot tipsen
SIF - industritjänstemännens förbund

NTF - varnar om trafiken
KKK - gör negern besviken
SCB - räknar allting i procent

HMK - Carl Gustav heter kungen
PTH - till höger om pungen
USA - dom har en sugen president

BMX - cyklar i skogen
DBS - cyklar i Norge
ATP - för alla som är 65

MTV - e videokanalen
VVS - när man rensat analen
VHS - har nästan alla i sitt hem

SNM - man smiskar och njuter
IRA - dom bombar och skjuter
HBK - var bäst på fotboll -97

EAN - streckade koder
ASG - en lastbil med låder
ABB - kan vi inte sluta nu

JFK - den säg jag på bio
ELP - en 70-tals-trio
CSN - betala hela livet
TV3 - va dåliga dom har blivit
ELO - elektrisk orkester
OMD - en annan orkester
ALU - jobb för miljoner
GRU - ryska spioner
Y2K - 20-hundratalet
SAP - vill nog gärna vinna valet
DDR - innan muren försvann
PMS - det får aldrig en man
DKW - tyska maskiner
UNO-X - säljer bensiner
BNP - debet och kredit
KAS - som att ha ledit
BVC - för nyfödda ungen
NHL - där Foppa är kungen
HIV - kan smitta vid ett skjut

Ska vi ta och kanske sluta nu då?
Jävla skit!